000000000000000000000000000000000000000000000000000000000
000000000000000000000000000000000000000000000000000000000
000100122222222222222222222222222222222222222200000000000
000100000000000000000000000000000000000000000000000000000
000100000000000000000000000000000000000000000000000000000
000100000000000000000000000000000000000000000000000000000
000100000000000000000000000001000000000000000000000000000
000100000000000000000000000001000000000000000000000000000
000100000000000000000000000001000000000000000000000000000
000100000000000000000000000001000000000000000000000000000
000100000000000000000000000001000000000000000000000000000
000100000000001111111111111111000000000000000000000000000
000100000000000000000000000001000000000000000000000000000
000100000000000000000000000001000000000000000000000000000
000100000000000000000000000001000000000000000000000000000
000100000000000000000000000001000000000000000000000000000
000100000000000000000000000001000000000000000000000000000
000100000000000000000000000001000000000000000000000000000
000100000000000000000000000000000000000000000000000000000
000100000000000000000000000000000000000000000000000000000
000000000000000000000000000000000000000000000000000000000
000000000000000000000000000000000000000000000000000000000
000000000000000000000000000000000000000000000000000000000
000000000000000000000000000000000000000000000000000000000
000000000000000000000000000000000000000000000000000000000
